  #  ##
# # ## 
#  B ##
# #  ##
 #   ##
##    #
# A #  

